  #RRRR#
  #RRRR#
####  ##
####  ##
#S## ###
     #F#
     ###
